1111111111111111111111111111
111000000000010000111001C111
110C111000110001100100010011
1111101101001010010101011001
1E000000000000000000000000P1
1111101101001010010101011111
110C111000110001100101010C11
1110000000000100000000000111
1111111111111111111111111111