111111111111111
111000000000001
1E00000X0000P01
1110000000000C1
111111111111111