1111111111111111111111111111
111000000000010000111001C111
11C0111000110001100100010011
1111101101X00000010101011001
1X00000000000E000000000000P1
1111101101000000X10101011111
11C0111000110001100101010C11
1110000000000100000000000111
1111111111111111111111111111