1111111111111111111111111111
111000000000010000111001C111
11C0111000110001100100010011
1111101101X00000010101011001
1C00000000001E100000000000P1
1111101101000100X10101011111
11C0111000110001100101010C11
1110000000000100000000000111
1111111111111111111111111111