111111111111111
111000000000001
1E0000000C00P01
111000000000001
111111111111111