111111111111111
1E00000000001C1
10000000000P111
100000000000001
111111111111111