111111111111111111111
110000000000000000011
110011111111111110011
110011111111111110011
110011111111111110011
110000000000000000011
111111111111111111111