1111111111111111111111111111
111000000000000000000110C111
110C111000110001100010010011
1001101101001010010100001001
1000000000000000000000000001
100110110100101001001E010001
110C111000110001100001100011
1110000000000P000000000C1111
1111111111111111111111111111